1111111111111111111111111111
1000000001110000000000000001
1000000001110000000000000001
1000000001110000000000000001
1000000000000000000000000001
1000000000000000000011111111
1000000000000000000000000001
1000000000000000000000011111
1000000000000000000000000001
1000000000000000000000000001
1000000000000000000000000001
1111111111111111111111111111